 translations: {
                profile: 'Profilis',
                coverPhoto: 'Viršelio nuotrauka',
                facebook: 'Facebook',
                socialMedia: 'Socialinė medija',
                fbProfileSize: 'Facebook profilio dydis',
                fbCoverPhotoSize: 'Facebook viršelio nuotraukos dydis',
                save: 'Išsaugoti',
                saveAs: 'Išsaugoti kaip',
                back: 'Atgal',
                loading: 'Kraunama',
                resetOperations: 'Atstatyti operacijas',
                changesLost: 'Visi pakeitimai bus prarasti',
                changesLostConfirmation: 'Ar tikrai norite atstatyti visas operacijas?',
                width: 'Plotis',
                height: 'Aukštis',
                custom: 'Pasirinktinis',
                original: 'Originalus',
                custom_size: 'Pasirinktinis dydis',
                editImage: 'Redaguoti paveikslėlį',
                adjust: 'Koreguoti',
                effects: 'Efektai',
                filters: 'Filtrai',
                crop: 'Apkirpti',
                resize: 'Keisti dydį',
                rotate: 'Pasukti',
                text: 'Tekstas',
                draw: 'Piešti',
                shapes: 'Formos',
                image: 'Paveikslėlis',
                background: 'Fonas',
                selectFont: 'Pasirinkti šriftą',
                selectFontFamily: 'Pasirinkti šrifto šeimą',
                fontSize: 'Šrifto dydis',
                lineHeight: 'Eilutės aukštis',
                letterSpacing: 'Raidžių tarpai',
                color: 'Spalva',
                addNewLayer: 'Pridėti naują sluoksnį',
                addText: 'Pridėti tekstą',
                addImage: 'Pridėti paveikslėlį',
                addDrawing: 'Pridėti piešinį',
                addRect: 'Pridėti stačiakampį',
                addCircle: 'Pridėti apskritimą',
                addPolygon: 'Pridėti daugiakampį',
                addLine: 'Pridėti liniją',
                goBack: 'Grįžti atgal',
                reset: 'Atstatyti',
                done: 'Atlikta',
                undoTitle: 'Atšaukti paskutinį veiksmą',
                redoTitle: 'Pakartoti paskutinį veiksmą',
                showOriginal: 'Rodyti originalą',
                zoomIn: 'Priartinti',
                zoomOut: 'Atitolinti',
                toggleZoom: 'Perjungti priartinimą',
                rotateLeft: 'Pasukti kairėn',
                rotateRight: 'Pasukti dešinėn',
                flipHorizontally: 'Apversti horizontaliai',
                flipVertically: 'Apversti vertikaliai',
                brightness: 'Ryškumas',
                contrast: 'Kontrastas',
                saturation: 'Sodrumas',
                exposure: 'Ekspozicija',
                vibrance: 'Gyvybingumas',
                warmth: 'Šiltumas',
                hue: 'Atspalvis',
                gamma: 'Gama',
                clarity: 'Aiškumas',
                sharpen: 'Paryškinti',
                blur: 'Sulieti',
                noise: 'Triukšmas',
                pixelate: 'Pikselizuoti',
                fullCrop: 'Pilnas apkirpimas',
                addAPhoto: 'Pridėti nuotrauką',
                editPhoto: 'Redaguoti nuotrauką',
                fillColor: 'Užpildymo spalva',
                moreSettings: 'Daugiau nustatymų',
                lessSettings: 'Mažiau nustatymų',
                useAsBackground: 'Naudoti kaip foną',
                outlined: 'Apibrėžtas',
                shadow: 'Šešėlis',
                italic: 'Kursyvas',
                underline: 'Pabrauktas',
                uppercase: 'Didžiosios raidės',
                lowercase: 'Mažosios raidės',
                changeText: 'Keisti tekstą',
                editText: 'Redaguoti tekstą',
                add: 'Pridėti',
                cancel: 'Atšaukti',
                remove: 'Pašalinti',
                apply: 'Taikyti',
                opacity: 'Nepermatomumas',
                strokeWidth: 'Linijos plotis',
                strokeColor: 'Linijos spalva',
                backgroundColor: 'Fono spalva',
                radius: 'Spindulys',
                rulerTool: 'Liniuotės įrankis',
                resize: 'Keisti dydį',
                watermark: 'Vandens ženklas',
                focus: 'Fokusas',
                vignette: 'Vinjetė',
                shadows: 'Šešėliai',
                highlights: 'Paryškinimai',
                temperature: 'Temperatūra',
                tint: 'Atspalvis',
                imageError: 'Klaida įkeliant paveikslėlį',
                imageSizeTooLarge: 'Paveikslėlio dydis per didelis',
                imageSizeTooSmall: 'Paveikslėlio dydis per mažas',
                imageTypeNotSupported: 'Paveikslėlio tipas nepalaikomas',
                somethingWentWrong: 'Kažkas nepavyko',
                cropLimitReached: 'Pasiektas apkirpimo limitas',
                sizeRestrictions: 'Dydžio apribojimai',
                uploadImage: 'Įkelti paveikslėlį',
                openEditor: 'Atidaryti redaktorių',
                download: 'Atsisiųsti',
                size: 'Dydis',
                format: 'Formatas',
                quality: 'Kokybė',
                name: 'Pavadinimas',
                edit: 'Redaguoti',
                delete: 'Ištrinti',
                ok: 'Gerai',
                yes: 'Taip',
                no: 'Ne',
                close: 'Uždaryti',
                loading: 'Kraunama',
                error: 'Klaida',
                success: 'Sėkmingai',
                warning: 'Įspėjimas',
                info: 'Informacija',
                confirm: 'Patvirtinti',
                reject: 'Atmesti',
                chooseFile: 'Pasirinkti failą',
                dropFileHere: 'Įkelkite failą čia',
                orClickHere: 'arba spauskite čia',
                maxFileSize: 'Maksimalus failo dydis',
                maxFileSizeExceeded: 'Viršytas maksimalus failo dydis'
            },